NO ./assets/Wall_NO.xpm
SO ./assets/Wall_SO.xpm
WE ./assets/Wall_WE.xpm
EA ./assets/Wall_EA.xpm

F 220,100,0
C 250,30,0

        1111111111111111111111111
        1000000000110000000000001
        1011000001110000000000001
        1001000000000000000000001
111111111011000001110000000000001
100000000011000001110111111111111
11110111111111011100000010001
11110111111111011101010010001
1100000011010101110000000001
10000000000000001100000000001
1000000001000000001010N000001
110000011010101111101111000111
11110111 1111101 101111010001
1111111 1111 111111111111111 