NO ./assets/Tile.xpm
SO ./path_to_the_south_texture
WE ./path_to_the_west_texture
EA ./path_to_the_east_texture

F 67,135,94
C 135,206,235

1111111
1000001
1000001
1111001
100N001
1000001
1111111